1111111111111111111111111111111111
1400001000000000000001000001000001
1000001000000000000002000002000001
1000001000000000000000000000000001
1000001000000000000001000001111301
1111301111301111111111130111000041
1000001000000000010001000002000001
1000001000000000020002000000000001
1000002000000000000000000001000001
1000000000000000011111000001000001
1000001000000000014001000001000001
1000001000000000010002000001000001
1000001000000000010000000002000001
1000001000000000011111000000000001
1000001111301111114002000001111111
1000002000000000010000000002400001
1400000000000000020001000000000001
1111111000000000000001000001000001
1111111111111111111111111111111111