1111111111111111111111111111111111
1000100000000000000000000000000001
1000110000000000000000000000000001
1000000000000000000000000000000001
1000000000000000000000000000000001
1000000000000000000000000000000001
1000000000000000000000000000000001
1000000000000000000000000000000001
1000000000000000000000000000000001
1000000000000000000000000000000001
1000000000000000000000000000000001
1000000000000000000000000000000001
1000000000000000000000000000000001
1000000000001110000000000000000001
1000000000001010000000000000000001
1000000000001110000111100000000001
1000000000000000000000100000000001
1000000000000000000000100000000001
1111111111111111111111111111111111