1111111111111111111111111111111111
1300001000000000000001000001000001
1000001000000000000002000002000001
1000001000000000000002000002000001
1000001000000000000001000001111221
1111221111444111111111144411000031
1000001000000000010001000002000001
1000001000000000020002000002000001
1000002000000000020002000001000001
1000002000000000011111000001000001
1000001000000000013001000001000001
1000001000000000010002000001000001
1000001000000000010002000002000001
1000001000000000011111000002000001
1000001111444111113002000001111111
1000002000000000010002000002300001
1300002000000000020001000002000001
1111111000000000020001000001000001
1111111111111111111111111111111111